0,3 
5,0
00 00 00 00 00 00 00 00 00 00
00 00 00 00 00 00 00 00 00 00
13 00 13 00 10 00 00 00 00 00
20 00 11 00 10 00 00 00 00 00 
00 00 00 00 00 00 00 00 00 00
00 00 12 00 11 00 00 00 00 00
00 00 00 00 00 00 00 00 00 00
