0,3 
5,0
12 12 12 12 12 12 12 12 12 12
11 10 10 10 10 10 10 10 10 13
11 10 10 10 10 13 10 10 10 13
20 11 11 11 11 10 10 10 10 13 
11 10 10 10 12 10 10 10 10 13
11 10 10 10 12 11 11 10 10 13
11 10 10 10 10 10 10 10 10 13
