0,3 
5,0
00 00 00 00 00 10 00 00 00 00
00 00 00 00 00 10 00 00 00 00
00 00 00 00 00 13 10 00 00 00
11 11 11 11 11 00 10 00 00 00 
00 00 00 00 12 00 10 00 00 00
00 00 00 00 12 11 11 00 00 00
00 00 00 00 00 00 00 00 00 00
